22222222
20000042
20302022
22200042
20300202
20020002
20100202
22222222
 
  
  
  
  
  
  
   
