22222222
22040242
20300202
20000202
20300202
22024232
20100002
22222222
