22222222
20404242
20000202
20020002
20300202
20030032
20102002
22222222
